LAYER
.......................
.......................
.......................
.......................
....#########..###.....
....#########..###.....
....##.................
....##......######.....
....#######..#####.....
.......................
.......................
.......................
.......................
.......................
END
