LAYER
.......................
.......................
....##########.........
....#........#.........
....#........#.........
....#........#.........
....#........#.........
....#........#.........
....#..................
....####...###.........
..................p....
.......................
END
LAYER
.......................
.......................
....##########.........
....#........#.........
....#........#.........
....#........#.........
....#........#.........
....#........#.........
....#........#.........
....##########.........
.......................
.......................
END
