............................................................................
............................................................................
............................................................................
............................................................................
.....############################...........................................
.....#..........x...............#...........................................
.....#.........x....x...........######################......................
.....#....x..........................................#......................
.....#...................t.....................x.....#......................
.........xx...x......................................#......................
....................x..............x...xx............#......................
.................................x.xxx..t............#......................
...........x.....................t.x..........x......#......................
.....#...............................................#......................
.....#..............x...........###########........###......................
.....#............t.............#....#.............#........................
.....##########........########....#.............###........................
..............#...#.......#........#........t.x..#..........................
.........p....#...#.......#........#.............#..........................
..............#...#.......#........#.......xx....#..........................
..............#...#.......#........###############..........................
..............#.#############...............................................
..............#.#...........................................................
..............#.#...........................................................
..............#.#...........................................................
..............#.#...........................................................
..............#.#...........................................................
