......................................
......................................
......................................
......................................
.......#########..###.................
.......#########..###.................
.......##.............................
.......##......######.................
.......#######..#####.................
......................................
......................................
......................................
......................................
......................................
